AFFILIATION	AH F IH L IY EY SH AH N
ARE	AA R
ARE(2)	ER
DATE	D EY T
DAY	D EY
FROM	F R AH M
HOW	HH AW
IS	IH Z
ME	M IY
NAME	N EY M
PLEASE	P L IY Z
TELL	T EH L
THE	DH AH
THE(2)	DH IY
TODAY	T AH D EY
TODAY(2)	T UW D EY
WE	W IY
WEATHER	W EH DH ER
WHAT	W AH T
WHAT(2)	HH W AH T
WHERE	W EH R
WHERE(2)	HH W EH R
YOU	Y UW
YOUR	Y AO R
YOUR(2)	Y UH R
