A	AH
A(2)	EY
ALREADY	AO L R EH D IY
ALREADY(2)	AO R EH D IY
B	B IY
BAR	B AA R
C	S IY
COKE	K OW K
COOKIE	K UH K IY
FOLLOW	F AA L OW
I'VE	AY V
JUICE	JH UW S
KITCHEN	K IH CH AH N
LAMYAI	L AE M AY EY
ME	M IY
MODE	M OW D
MY	M AY
NO	N OW
ORANGE	AO R AH N JH
ORANGE(2)	AO R IH N JH
ORDER	AO R D ER
PLEASE	P L IY Z
SERVE	S ER V
SNACK	S N AE K
STANDBY	S T AE N D B AY
STOP	S T AA P
TABLE	T EY B AH L
TAKE	T EY K
WATER	W AO T ER
YES	Y EH S
