BOTTLE	B AA T AH L
FOLLOW	F AA L OW
FOUR	F AO R
GET	G EH T
GET(2)	G IH T
HELP	HH EH L P
I	AY
ME	M IY
MY	M AY
NEED	N IY D
NO	N OW
ONE	W AH N
ONE(2)	HH W AH N
PILLS	P IH L Z
PLEASE	P L IY Z
ROBOT	R OW B AA T
ROBOT(2)	R OW B AH T
STOP	S T AA P
THREE	TH R IY
TWO	T UW
YES	Y EH S
